..............................
..............................
.....#..................#.....
.....#..................#.....
.....#..................#.....
.....#..................#.....
.....#..................#.....
.....####################.....
..............................
..............................
..............................
..............................
..............................
..............................
..............................
..............................
..............................
..............................
..............................
..............................
..............................
..............................
.....####################.....
.....#..................#.....
.....#..................#.....
.....#..................#.....
.....#..................#.....
.....#..................#.....
..............................
..............................
