################################
#..............................#
#..............................#
#.....#..................#.....#
#.....#..................#.....#
#.....#..................#.....#
#.....#..................#.....#
#.....#..................#.....#
#####.####################.#####
#..............................#
#..............................#
#..............................#
#################.##############
#..............................#
#..............................#
##.#############################
#..............................#
#..............................#
##############################.#
#..............................#
#..............................#
######.#########################
#..............................#
#.....##################.#.....#
#.....#..................#.....#
#.....#..................#.....#
#.....#..................#.....#
#.....#..................#.....#
#.....#..................#.....#
#..............................#
#..............................#
################################

